+----+----+
|fffffffff|
|f+--+--+f|
|ffff|ffff|
|f|ff|ff|f|
|f+--+--+f|
|f|ff|ff|f|
|f|ff|ff|f|
|f+f-+-f+f|
|fffffffff|
+----+----+